STEPS:15    
                
                
         *******
         *  U  *
         * DDL *
         *UD*UU*
         * RUU *
         *  U  *
         *******