STEPS:25       
               
               
         ******
         * RU *
         *UUUL*
         * UL *
         * RU *
         *UULU*
         * UL *
         * RD *
         *RURU*
         * RD *
         ******