STEPS:14       
               
               
               
               
         ******
         *UUDD*
         *L  R*
         *L  R*
         *UUDD*
         ******