STEPS:35           
                   
                   
         **********
         * UUU    *
         * LDL    *
         *RRRR   U*
         * ULLLLU *
         * LLLRRU *
         * DLLRRR *
         *  DDDD  *
         **********