STEPS: 17
Difficulty:Medium
*********
* ULLDD *
* R  R  *
*  DR  R*
*  LLD *
* URRR *
*********
